0 0 0 7 3 0 0 3 7 0 1 1 1 1 1 1 1 1 1 1 1 1 1 1 2 2 2 1 1 1 1 1 1 1 1 1 1 1 1 1 1 1 1 1 1 1 1 1 1 1
7 3 3 0 7 3 7 7 7 7 0 0 3 0 6 0 7 0 0 0 0 0 3 3 2 2 2 3 0 0 0 0 3 3 0 0 0 0 0 6 6 0 3 0 0 0 3 7 0 1
3 7 7 7 7 7 0 3 3 7 0 3 0 0 0 0 0 0 6 0 0 0 0 0 2 2 2 0 0 0 7 0 0 0 0 3 6 0 3 3 0 0 0 0 6 0 0 3 0 1
7 3 7 7 0 3 7 3 7 3 0 6 0 0 0 7 0 0 0 3 0 3 0 7 2 2 2 3 0 3 0 0 3 0 0 0 7 0 0 0 6 0 0 0 0 0 0 0 0 1
7 7 0 3 0 7 3 0 7 7 0 0 0 7 0 3 0 0 0 0 3 3 7 0 2 2 2 0 7 6 0 0 6 0 0 7 7 3 0 0 0 7 0 3 3 3 6 6 0 1
0 7 0 3 7 7 7 0 7 7 3 0 0 0 7 7 0 0 7 6 6 3 7 0 2 2 2 0 0 0 7 0 0 0 0 0 6 0 0 0 0 3 0 0 6 7 0 0 3 1
0 7 7 3 0 0 7 7 7 0 0 3 3 0 0 3 0 0 0 0 0 0 0 3 2 2 2 3 3 7 6 0 0 0 0 0 3 7 6 0 7 0 0 7 0 3 0 3 0 1
7 7 7 3 0 3 7 7 7 0 3 0 6 0 0 0 0 0 3 7 3 6 7 0 2 2 2 7 0 7 0 3 0 0 7 0 3 0 0 0 0 0 6 7 0 6 0 7 0 1
7 3 0 3 0 7 3 7 7 3 3 0 7 0 0 0 3 0 7 0 0 0 7 0 2 2 2 0 0 3 0 6 6 3 0 0 0 3 7 3 7 3 0 0 0 0 7 0 3 1
0 0 0 3 0 7 7 0 3 3 3 0 0 0 0 0 0 7 0 0 6 6 6 0 2 2 2 0 0 7 0 0 0 3 3 7 3 0 6 0 3 7 7 3 0 7 0 0 0 1
1 0 6 0 7 0 0 0 6 0 7 3 6 6 0 3 3 0 0 0 0 0 0 0 2 2 2 0 0 3 6 0 0 6 0 0 6 0 0 0 0 0 7 3 3 6 3 3 7 1
1 0 0 0 6 3 0 7 3 0 6 0 0 6 0 6 0 0 0 6 0 6 0 3 2 2 2 0 3 0 0 0 0 0 3 0 0 0 3 0 7 3 0 0 0 3 0 0 6 1
1 3 6 0 6 7 7 0 0 6 0 7 0 7 3 0 3 3 0 0 6 3 0 0 2 2 2 0 3 0 0 7 7 7 0 0 3 0 0 0 0 7 0 0 3 0 3 0 0 1
1 0 0 3 3 3 0 0 3 7 7 0 7 7 0 0 3 6 0 0 0 0 0 3 2 2 2 0 3 0 0 3 3 0 6 0 0 3 7 3 3 0 0 3 7 3 0 0 3 1
1 0 0 7 0 6 0 0 7 6 0 6 3 3 0 3 3 6 0 0 3 7 0 0 2 2 2 3 0 0 0 3 3 0 0 3 0 7 6 0 3 0 0 3 0 0 0 0 3 1
1 7 0 3 0 0 7 0 3 0 3 0 0 3 0 3 0 0 6 7 3 0 0 0 2 2 2 3 3 0 0 7 0 3 7 3 0 0 0 3 3 0 0 3 0 0 0 0 6 1
1 0 0 0 3 0 3 3 7 0 0 6 0 0 0 0 0 0 6 0 0 0 3 0 2 2 2 0 0 0 0 0 0 3 0 0 3 0 0 7 0 0 3 0 7 3 0 7 0 1
1 0 0 0 7 0 0 3 0 3 7 0 0 3 6 0 7 0 3 0 0 0 0 3 2 2 2 3 0 0 3 3 0 0 0 3 0 7 0 0 7 7 0 3 3 3 6 6 3 1
1 0 0 0 0 0 6 7 6 0 0 3 0 6 0 0 0 0 0 3 0 0 6 0 2 2 2 7 0 3 3 0 3 6 0 0 0 0 0 7 0 0 3 7 3 0 3 3 3 1
1 7 0 0 7 0 0 6 3 6 0 3 0 0 3 6 0 0 0 0 0 6 0 0 2 2 2 0 3 0 3 0 0 7 0 0 0 0 0 0 0 6 0 0 0 3 0 6 6 1
1 3 0 0 3 0 3 0 3 6 3 0 3 3 0 3 0 3 0 3 0 7 0 0 2 2 2 0 0 3 0 6 3 3 0 0 7 3 0 0 0 3 0 6 0 0 7 6 0 1
1 0 0 6 6 3 6 0 0 0 3 3 3 3 7 0 3 7 3 0 7 0 7 0 2 2 2 0 0 0 0 3 3 0 0 0 0 0 3 0 3 0 0 3 6 0 0 3 0 1
1 0 7 0 0 0 6 0 0 3 3 7 7 3 0 3 3 0 3 0 3 0 0 7 2 2 2 0 0 0 3 7 0 0 0 0 7 7 0 0 0 3 7 6 0 0 3 0 3 1
1 7 0 6 3 3 3 0 0 0 3 3 7 3 3 0 0 0 3 0 7 0 0 0 2 2 2 3 0 3 0 0 7 3 0 3 0 7 7 7 0 7 0 0 3 0 0 3 3 1
1 7 7 3 0 0 0 0 6 3 3 0 3 0 3 0 3 3 0 7 3 0 0 6 2 2 2 0 0 7 0 0 7 7 7 3 0 0 6 3 0 0 0 3 7 0 0 0 0 1
1 6 6 6 6 6 6 6 6 6 0 0 3 0 3 3 0 3 3 7 7 6 6 6 4 4 4 6 6 6 6 6 6 6 6 6 6 6 6 6 6 6 6 6 6 6 6 6 6 1
1 0 3 0 0 3 6 0 7 7 3 0 0 0 0 3 3 3 7 3 3 0 7 0 2 2 2 0 3 0 6 3 3 6 7 0 0 0 6 6 0 3 0 3 3 3 3 0 0 1
1 7 0 0 3 0 0 0 0 3 3 0 0 0 0 3 7 7 3 0 7 0 0 0 2 2 2 0 0 0 7 3 0 0 3 6 7 6 0 0 0 3 0 0 3 0 0 0 0 1
1 7 3 7 6 0 6 3 0 0 7 0 3 0 3 3 0 0 7 3 7 3 3 3 2 2 2 0 7 0 0 6 0 3 0 6 0 0 6 3 0 0 6 0 0 3 3 0 0 1
1 3 3 3 6 0 0 0 7 6 0 0 3 7 3 3 3 0 0 0 0 3 0 0 2 2 2 3 6 3 0 0 0 0 6 6 7 3 7 3 0 3 7 0 0 6 0 0 0 1
1 7 0 0 6 0 7 0 0 3 7 0 0 3 0 3 0 0 0 0 7 0 7 0 2 2 2 3 3 0 0 0 3 3 0 0 6 0 3 0 0 0 0 0 3 0 0 3 0 1
1 0 0 3 0 0 3 0 0 0 6 0 0 0 0 3 3 0 0 3 3 0 0 3 2 2 2 3 0 6 0 0 0 0 0 0 0 6 3 0 0 0 0 0 3 3 3 0 3 1
1 0 0 0 3 7 0 3 0 0 0 0 0 0 7 0 3 0 3 0 3 0 0 0 2 2 2 0 3 3 0 3 0 0 0 6 0 0 7 0 3 0 0 3 7 0 3 0 3 1
1 6 3 0 3 0 0 0 7 0 6 0 0 0 3 3 0 3 0 0 3 0 7 0 2 2 2 0 0 6 6 0 3 0 6 3 3 7 7 0 3 3 0 6 0 0 0 0 7 1
1 6 0 0 0 0 0 0 0 0 0 7 0 0 3 0 6 0 0 0 0 3 6 3 2 2 2 0 0 0 0 0 0 0 3 0 0 0 3 0 0 0 7 0 3 3 6 0 3 1
1 7 0 7 0 0 0 0 3 0 0 0 0 3 7 7 0 0 0 0 7 0 0 7 2 2 2 0 6 0 0 0 0 3 0 0 0 6 0 0 0 0 6 3 0 3 0 3 0 1
1 7 0 0 3 6 0 3 0 0 0 0 6 0 0 6 0 3 7 3 0 3 0 0 2 2 2 0 3 6 0 3 0 0 7 3 5 5 5 5 5 5 5 5 5 5 5 5 5 6
1 0 0 0 0 3 0 0 0 0 0 0 0 0 0 6 7 3 0 0 6 3 0 3 2 2 2 7 3 0 6 7 0 7 0 0 5 6 5 5 5 5 5 5 5 5 5 5 5 5
1 0 0 3 6 6 0 0 0 0 0 0 0 6 0 0 0 3 3 0 0 6 3 0 2 2 2 0 3 0 0 6 0 0 7 3 5 5 5 5 6 5 5 5 5 5 5 6 5 5
1 0 6 0 0 7 7 0 0 0 0 7 0 3 0 0 3 0 0 7 7 3 0 0 2 2 2 0 3 7 7 0 0 0 0 0 5 5 5 5 5 5 5 5 5 5 6 5 6 5
1 0 6 0 0 3 7 0 3 0 3 0 0 3 0 3 7 0 0 6 0 0 0 6 2 2 2 0 6 0 7 0 0 0 0 6 5 5 5 5 6 6 5 5 5 6 5 5 6 5
1 0 0 0 0 0 7 0 0 0 0 3 3 0 3 0 0 0 0 0 0 0 0 7 2 2 2 0 0 7 0 3 3 0 7 0 5 5 5 5 6 5 5 5 5 5 5 6 5 5
1 7 0 7 3 7 6 0 0 3 0 0 0 6 0 6 0 0 6 7 7 6 0 0 2 2 2 0 0 0 7 7 0 0 0 0 5 5 5 5 6 6 5 5 5 5 5 5 5 5
1 0 3 0 6 0 0 6 0 0 0 3 0 7 0 3 0 0 6 0 6 0 0 0 2 2 2 3 0 0 0 3 0 0 3 0 5 5 5 5 5 5 5 5 5 5 5 5 6 5
1 0 6 3 0 0 7 0 0 3 0 0 3 6 3 6 7 0 0 0 0 0 0 0 2 2 2 6 0 0 0 6 6 0 0 3 5 5 5 5 5 5 5 5 5 5 5 5 5 5
1 6 7 0 0 3 7 3 7 3 0 7 0 0 0 0 0 3 0 3 0 0 0 0 2 2 2 3 0 0 0 3 0 7 6 7 5 5 5 5 5 5 5 5 5 5 5 6 5 5
1 6 7 3 0 0 6 0 0 0 0 0 3 0 0 0 0 0 0 0 6 0 7 3 2 2 2 6 3 0 0 0 7 3 0 0 6 5 5 5 5 6 5 5 5 5 5 5 5 5
1 0 0 7 0 0 0 0 0 0 3 3 0 0 7 3 0 0 0 3 7 0 0 0 2 2 2 0 6 0 0 6 6 0 0 0 5 5 6 5 5 5 5 5 5 6 5 5 5 5
1 0 6 3 3 6 0 6 0 3 3 0 0 0 0 3 0 0 0 0 0 0 0 0 2 2 2 0 0 0 7 0 0 0 3 3 5 5 6 5 5 5 5 5 5 5 5 5 6 5
1 1 1 1 1 1 1 1 1 1 1 1 1 1 1 1 1 1 1 1 1 1 1 1 2 2 2 1 1 1 1 1 1 1 1 1 6 5 6 5 5 5 5 6 5 5 5 5 5 5